XXXXXXXXXXXXXXXXXXXXXX
X XX        X X      X
X    XXXXXX X XXXXXX X
XXXXXX     S  X      X
X    X XXXXXX XX XXXXX
X XXXX X         X   X
X        XXX XXX   X X
XXXXXXXXXX    XXXXXX X
XG         XX        X
XXXXXXXXXXXXXXXXXXXXXX
